***_****4*
*________*
*2**_*****
*________*
**_*****_*
*________*
*_***_**_*
*________*
****_***6*
**_*****_*
*________*
*_**2*_*_*
*________*
*_*_*_**_*
*________*
***_****8*
*________*
********_*
*________*
*_****_***
*________*
**6*_**_**
*________*
**********